  ##### 
###   # 
#.@$  #
### $.#
#.##$ #
# # . #
#$ *$$.#
#   .  #
########