#########
#####.. #
######  #
#### $  #
#### $ ##
####@  ##
#########