#########
#@      #
# $$$...#
#    ###
#    #
######