######
##.. #
###  #
# $  #
# $ ##
#@  ##
######