 #######
 #  #  #
 #$ .@$#
 # .#. #
##$.#.$##
# $ . $ #
#   #   #
#########